1111111111111
100100E000001
1000010000001
100011P001101
1111111111111