1111111111111
100100E000001
1000010001111
100011P001C01
1111111111111