111111
100001
10P001
10CE01
111111