1111111111111111111111
1C000000000010000000P1
1001111111111000111111
1001C000000000000C0001
1000111111111111001101
10001E000000000000C101
1000111111111111000101
100100000C000000011101
1000000000000000000001
100100000C000000011101
1111111111111111111111